rows 15
cols 15
players 2

m %%%....%.......
m %......%.......
m %......%....%..
m %..B%..%....%..
m %..%%.....%%%..
m ...............
m .......%.......
m %%%%%..%..%%%%%
m .......%.......
m ...............
m ..%%%.....%%..%
m ..%....%..%A..%
m ..%....%......%
m .......%......%
m .......%....%%%