rows 12
cols 12
players 2

m %%..%..%...%
m %...%..%...%
m ....%..%B..%
m %......%%..%
m %..%%.......
m ...%....%%%.
m .%%%....%...
m .......%%..%
m %..%%......%
m %..A%..%....
m %...%..%...%
m %...%..%..%%